IX-1p KNOW-THAT IX-3p:i MONSTER HOUSE IX-1p SUFFER ENTER fs-AT POSS-1p #OWN fs-RISK	 I know that I should enter the haunted house at my own risk.
BUY FLOWER WHO	 Who buys flowers?
IX-1p NOT SKILL (1h)part:indef	 I'm not skilled.
IX-1p FINISH KNOW+ HAVE PINEAPPLE fs-CREAM CHEESE+	 I already know that there's pineapple cream cheese.
NOT fs-JOHN (1h)5"perplexed" REALLY WOW/AWFUL (1h)part:indef	 His name is not John...Wow, it's awful.
IX-loc:i RAIN+ IX-loc:i IX-1p IMPOSSIBLE+ FIND/FIND-OUT UMBRELLA (1h)part:indef	 It's raining and it's impossible to find an umbrella.
BOY+ BICYCLE SCL:3"bike crashing" SCL:3"fall off bike"	 The boy's bike crashed and he fell off.
WHO LOVE fs-BILL (1h)part:indef	 Who loves Bill?
#NO+ NOT STOP 5"perplexed"	 No, he/she didn't stop.
fs-JOHN IX-3p:i NOT DRIVE fs-MARY TO/UNTIL WORK (1h)5"wave no" IX-3p:i DRIVE TO/UNTIL SCHOOL+++	 John isn't driving Mary to work, he's driving her to school.
CAR IX-loc:i FULL #GAS HAVE (1h)part:indef	 The car has a full tank of gas.
fs-JACK STAND GO-OUT+ IX-3p:i SEE SOMETHING/ONE STRANGE QMwg	 When Jack was standing outside did he see something/someone weird?
IX-3p:i fs-MARY FUNNY IX-3p:i WANT+ UGLY #DOG2 part:indef	 Mary is funny. She really wants an ugly dog.
POSS-1p TEACH+AGENT IX-3p:i (1h)GOOD/THANK-YOU ADVISE/INFLUENCE++AGENT (1h)GOOD/THANK-YOU	 My teacher is a good advisior.
MOTHER IX-loc:i NICE/CLEAN+ (1h)"WHAT" IX-3p:i	 What did mom clean?
fs-BILL PLAN (1h)MOVE ns-NEW-YORK QMwg	 Is Bill planning on moving to New York?
IX-3p:i CAR IX-loc:i BREAK-DOWN NOT #NO	 No, the car is not broken.
#IF+ KID PLAY-continuative fs-PARK IX-loc:i NIGHT+ FUTURE EXAUST	 If the kids play at the park, they will be exausted tonight.
IX-1p NOT LIKE CHOCOLATE fs-CEREAL #NO++	 No, I don't like chocolate cereal.
IX-2p LIKE PHYSICS CLASS IX-2p	 Do you like physics class?
(2h)LOOK-FORWARD FOOTBALL+ GAME IX-2p	 Are you watching the football game?
fs-SUE MOVE WHERE	 Where did Sue move?
STRANGE fs-MARY TELL-1p ARRIVE HOME AROUND MIDNIGHT IX-1p LOOK:i THINK ARRIVE THREE2 MORNING	 It's weird because Mary told me she would be home around midnight but I think she won't get home until three in the morning.
MOTHER SCL:bent-U-L"person walking" WHERE	 Where did Mother walk to?
YESTERDAY ALL-DAY IX-1p WORK++	 Yesterday I worked all day.
IX-1p WARM (1h)5"wave no" IX-1p COLD2	 I am not warm, I am cold!
MOTHER+ NAME fs-JANET #NO+ NAME fs-JANE	 Mother's name is Jane, not Janet.
POSS:1p FRIEND (2h)IX-3p:i WANT+NEG GO-OUT THUMB-IX-3p:i	 My friend doesn't want to go out.
LEAVE-THERE BOOK DCL:B-L"stack of books" POSS-1p fs-OFFICE IX-loc:i WHO IX-3p:i part:indef	 Who left their book in my office?
HERE ns-BOSTON NOT MANY ANIMAL+ part:indef	 There's not many animals here in Boston.
DEPART WHO	 Who's going out?
5"wave no" IX-1p VOMIT/HATE CHOCOLATE DRY-CEREAL IX-1p	 No no no, I hate chocolate cereal.
IX-3p:i fs-MARY MAYBE BORN FUTURE WIDE BABY MAYBE	 Maybe Mary will give birth to a big baby.
IX-1p SAY fs-JOHN (1h)5"wave no" IX-1p CREATE/PRETEND fs-JAMES	 Did I say John? Oh, I made that up. I meant James.
WHO LOVE fs-MARY	 Who loves Mary?
IX-3p:i (5)MAN PAINT+ POSS-1p HOUSE IX-3p:i POSS-1p SISTER KNOW+ IX-3p:i PAST	 The man who is painting my house, my sister knew him from a long time ago.
fs-JACK IX-loc:i LIE IX-3p:i NOT SICK IX-3p:i	 Jack lied. He's not sick.
fs-JOHN DRIVE fs-MARY WORK #NO (1h)5"wave no" IX-loc:i (1h)TEND fs-AMY	 Does John drive Mary to work? No, he usually drives Amy to work.
IX-1p-pl-2:i MUST DEPART:j TOGETHER/GO-STEADY:j	 We should leave together.
IF IX-1p STUDY FUTURE FAIL	 If I don't study, I will fail.
#IF IX-3p:i HAVE TIME+ IX-3p:i FUTURE COOK+ COOKIE	 If he has time, he will bake cookies.
NEAR SEMESTER SOON FINISH IX-1p DEAF-APPLAUSE SOCIAL/INTERACT (1h)5"wave no" CANNOT	 Near the end of the semester, I cannot socialize as much.
IX-3p:i LOVE fs-BILL IX-3p:j WHO IX-3p:i	 Who loves Bill?
FATHER+ IX-loc:i LIKE CHOCOLATE DRY-CEREAL i:SAME-1p+	 Dad likes chocolate cereal, like me.
IF IX-2p STUDY IX-2p FUTURE A CLASS	If you study consistently, you will ace the class.
WORK++ HAPPEN COMPUTER5 CRASH2 IX-1p 5"panic" fs-PANIC FUTURE IX-1p	 If I'm working and my computer crashes, I will panic.
WHEN RAIN++ IX-1p MUST LEAVE	 When it rains, I have to leave.
IX-1p NOT SEE (5)ACCIDENT part:indef IX-1p SLEEP part:indef	 I didn't see the accident, I was asleep.
fs-MARY IX-loc:i LIKE RED SHOE+	 Mary likes red shoes.
IX-loc:i ILLEGAL #IF NONE/NOTHING2 fs-TAX ILLEGAL	 It's illegal to not have a tax.
IX-1p (1h)HAPPY+ NONE/NOTHING2 #NO+ IX-1p SAD 5"ok (giving in)"	 I'm not happy, I'm sad.
(D)DOCTOR+ i:INFORM-1p MOTHER IX-loc:i ACTION STRANGE IX-3p:i BETTER GO HOSPITAL ALL-NIGHT (1h)STAY	 The doctor told me that Mom was acting strange and that she better go to the hospital and stay overnight.
fs-JOHN IX-3p:i FUTURE DRIVE IX-3p:j fs-MARY WORK	 John will drive Mary to work.
WHO ARRIVE LATE+ part:indef WHO	 Who arrived late?
IF+ fs-MARY POSS-3p:i CAR+ BREAK-DOWN fs-JOHN MUST TAKE WORK+	 If Mary's car broke down, John would have to take her to work.
#IF IX-3p:i NOT PASS IX-3p:j COURSE THIS IX-3p:i CANNOT GRADUATE IX-3p:i	 If he doesn`t pass this course, he can`t graduate.
NEXT-WEEK HOPE fs-JOHN ARRIVE ON TIME part:indef	 I hope John arrives on time next week.
NOT fs-EVEN RAIN LITTLE-BIT NONE/NOTHING2 part:indef	 It didn't even rain a little bit.
IX-1p NOT (1h)HAPPY+ (1h)part:indef	 I'm not happy.
IX-2p THINK+ fs-OBAMA VOTE AGAIN SECOND PRESIDENT QMwg	 Do you think Obama will be elected again for his second term as president?
IX-loc:i RAIN HAPPEN WHO GO-OUT part:indef	 Who went out when it was raining?
IX-3p:i PRESIDENT (1h)FINISH DEPART DO-DO IX-1p FUTURE TALK WITH IX-loc:j ANSWER+AGENT	 After the president left, he talked with the reporters.
HAPPEN IX-1p NOT STUDY++ HIT ALWAYS #QUIZ part:indef	 After not studying, there's always a pop quiz.
(P)PARTY2 PCL:5"people moving around" FINISH IX-1p CAN (1h)LEAVE HOME	 When the party is finished, I can go home.
(1h)HAPPY+ NOT (1h)HAPPY+ #NO+	 No, I'm not happy.
SISTER IX-3p:i NOT LIKE CHOCOLATE DRY-CEREAL (1h)part:indef	 My sister doesn't like chocolate cereal.
CAR BREAK-DOWN NOT	 No, the car is not broken.
#WHEN FRIEND GO-OUT IX-1p GRAB-CHANCE HOMEWORK+	 When my friends go out, I'll take the time to do homework.
(1h)5"wave no" CAR+ IX-3p:i NOT BREAK IX-loc:i IX-3p:j fs-TRUCK IX-loc:j BREAK IX-3p:j	 No, that car isn't broken, the truck is broken.
IX-1p (1h)WANT2 GO-OUT NOW	 I want to go out now.
WEATHER NOW BEAUTIFUL	 The weather today is beautiful.
IF+ IX-1p NOT STUDY+ IX-1p GUARANTEE FAIL IX-1p	 If I don't study, I am guaranteed to fail.
IX-1p VOLUNTEER/SHIRT HELP+ OTHER ORGANIZATION	 I volunteer to help other organizations.
COLD POSS-1p MOTHER NOT GO-OUT (1h)5"wave no"	 If it's cold, my mom won't go out.
FRIEND DYE HAIR DCL:5"hair dyed all over" TOGETHER/GO-STEADY2 WHY	 Why did the friends dye their hair together?
BOX/ROOM SMALL (1h)5"wave no" REALLY SMALL	 The box isn't small, it's tiny.
GO-OUT+ RAIN 5"wave no" (1)TEMPERATURE-DROP SNOW	 Is it raining outside? No, because the temperature dropped, it's snowing.
IX-2p FINALLY GET BOOK+ IX-2p READ CHAPTER TWO IX-2p	 When you get the book, read chapter two.
#IF IX-1p SWIM+ IX-3p:i fs-BEACH IX-1p SUN2 (2h)#BURN FUTURE IX-1p	 If I swim at the beach, I will definitely get a sun burn.
fs-MARY STOP ROWING+ 5"out of my control" NOT CONTINUE ROWING 5"no more"	 Mary stopped rowing. She's not going to do it any more.
TOMORROW IX-2p GO-OUT LIBRARY INTERPRET QMwg	 Are you going to interpret tomorrow at the library?
#IF+ MOTHER SCL:bent-U-L"person walking" SELL++ FUTURE BUY MILK	 If mom walks to the store, she will buy milk.
IX-1p WANT BUTTER+	 I want butter.
IX-3p:i APPLY IX-1p MANY fs-TASKS 5"frustration"	 They assigned me many tasks.
i:SAME-1p IX-1p WARM	 I am warm too.
IX-1p HERE ALL-DAY IX-1p WANT GO-OUT	 I've been here all day; I want to leave.
PRESIDENT WIFE ARRIVE WITH SCL:2"two people coming"	 The president and his wife arrived together.
IX-1p WARM (1h)5"wave no" IX-1p HOT	 I'm not warm, I'm hot.
ns-BOSTON WOW+ GREAT CITY/COMMUNITY3++	 Boston is a great city.
fs-JOHN IX-3p:i PAY/BUY TURKEY NONE/NOTHING2	 John didn't buy the turkey.
IX-1p ALMOST FINISH HOMEWORK	 I'm almost finished with my homework.
IX-1p WARM LATER2 HOT	 I start off warm and then later I get really hot.
IX-3p:i fs-JOHN IX-loc:i NOT (5)ACCIDENT IX-loc:j fs-TRUCK 5"wave no" IX-loc:i (5)ACCIDENT IX-loc:k #CAR CAR	 John didn`t get in a car accident with a truck, he was in an accident with another car.
fs-LATE IX-1p KNOW-THAT IX-1p FUTURE FINISH SOON++	 I know I'm late, but I will be finished soon.
BOY IX-loc:i PUT-AWAY+ (2h)alt.FIRE	 Did the boy feed the fire?
FATHER ARRIVE HOME WHEN	 When did Father arrive home?
IX-3p:i KNOW MANY DIFFERENT-arc (5)MAN	 He/She knows many different men.
CAR NOT BREAK IX-2p ICL:A"using key" WRONG fs-KEY (1h)part:indef	 The car isn't broken, you're using the wrong key.
POSS-1p+ CAR (2h)alt.FANCY BLUE SCL:3"big car"	 My car is fancy and blue.
#IF+ fs-JOHN DO THAT TO IX-1p IX-1p 5"whoa" RELATIONSHIP-OFF IX-1p	 If John did that to me, I won't be friends with him anymore.
ARRIVE HOME fs-LATE NIGHT+ WHO	 Who arrived home late tonight?
fs-JOHN DRIVE TAKE-continuative fs-MARY WORK+	 John is constantly driving Mary to work.
CAR IX-loc:i BREAK-DOWN	 The car is broken.
IX-1p D CLASS IX-1p ACCEPT	I got a D in the class; I accepted it.
IX-3p:i fs-JACK GO-OUT IX-3p:i SEE SOMETHING/ONE STRANGE QMwg (1h)part:indef	 When Jack went out, did he see something strange?
#IF+ FATHER ARRIVE HOME fs-LATE NIGHT+ IX-3p:i KNOW+(1h)NEG IX-1p-pl-arc NOT IX-loc:i (1h)part:indef	 If dad arrives home late, he won't know we aren't there.
LOSE KEY WHO	 Who lost the key?
SANDWICH2 IX-1p ICL:tight-C"eating sandwich" RECENT-PAST (Y)WOW DELICIOUS	 The sandwich I just ate was delicious!
(1h)5"wave no" IX-1p NOT LIKE CHOCOLATE DRY-CEREAL IX-1p	 No, I don't like chocolate cereal.
IX-3p:i TEACH+AGENT NOT REQUIRE READ+ DROP IX-3p:j fs-JOHN IX-loc:j NOT READ	 The teacher didn't make the reading required so John didn't read.
IX-3p:i (5)MAN (1h)FINISH TELL:j DO-DO+	 What did the man tell him/her?
IX-1p NONE (flat-O)PAY/SPEND IX-1p GO AUNT HOUSE EAT IX-loc:i	 If I don't have any money, I go to my aunt's house and eat there.
NOW (1h)HAVE BIG SCL:5-C"big house" HOUSE REALLY BEAUTIFUL	 Now there is a big expensive house. It's really beautiful.
POSS-2p FAMILY IMPORTANT (2h)IX-3p-pl-2 MOTHER+FATHER (2h)IX-3p-pl-2	 Your family, specifically your parents, are important.
IX-1p (1h)HAPPY+	 I'm happy.
fs-MARY IX-3p:i SELF-3p+:i VEGETABLE+AGENT	 Mary is a vegetarian.
FATHER IX-3p:i FUNNY MOTHER IX-3p:j SERIOUS	 Dad is funny, but Mom is serious.
FATHER ARRIVE HOME fs-LATE NIGHT+	 Did Father really arrive home late at night?
VEGETABLE IX-3p:i BROCCOLI IX-3p:j FINE EAT+ BUT IX-3p:k fs-SPINACH 5"whoa" REFUSE	 She is fine with broccoli, but she refuses to eat spinach.
NONE/NOTHING2 CAR IX-1p part:indef	 I don't have a car at all.
#NO IX-1p (2h)VOMIT/HATE++ #IF IX-1p EAT PINEAPPLE fs-CREAM CHEESE (1h)5"wave no" IX-1p FAVORITE/PREFER+ fs-LOX	 No, I would not stop vomitting if I ate pineapple cream cheese. I prefer lox.
STUDENT READ BOOK NOT-YET+	 The student has not yet read the book.
IX-3p:i FARM+ IX-loc:i LIKE HOT SUMMER EASY+ GROW+ BIG VEGETABLE ADULT-TALL-pl	 Farms like the hot summers because it's easy to grow big vegetables.
DEPART BUY+++ FINISH IX-1p SPEND TWO-HUNDRED DOLLAR part:indef	 I went shopping and spent two hundred dollars.
(Y)YESTERDAY RAIN+ ALL-DAY	 Yesterday, it rained all day.
IX-2p (1h)DO-DO THAT FOR-FOR IX-2p	 What is that for?
IX-1p NOT THRILL/WHAT'S-UP #IF HAVE PINEAPPLE fs-CREAM CHEESE part:indef	 I won't be thrilled if there's pineapple cream cheese.
(1h)5"whoa" IX-3p:i FUTURE BUY FLOWER FOR REALLY	 He will buy flowers for sure.
#NO+ IX-1p NOT GO-OUT:i	 No, I didn't go.
IF+ PRESIDENT VOTE AGAIN POSS-1p FATHER fs-UPSET FUTURE	 If the president is elected again, my father will be upset.
POSS-1p FATHER+ MOVE WHERE ns-CHICAGO	 My father moved here from Chicago.
IX-2p FINISH HOMEWORK IX-2p THEN CAN (1h)PLAY GO-OUT+	 When you finish homework, you can go play outside.
THAT DRESS/CLOTHES LCL:1"dress over there" 3"contemplation" NOT POSS-1p FAVORITE/PREFER+ part:indef	 That dress is not my favorite.
fs-PARK IX-loc:i (1h)TEND CROWDED WHY KID LIKE PLAY-continuative IX-loc:i	 The park tends to be crowded because kids like playing there.
#IF+ POSS-1p FAMILY PROCEED TAKE-UP DCL:crvd-B"small puppies" DOG IX-1p+ FUTURE BUY BEAUTIFUL COLLAR FOR IX-3p-pl-arc SMALL #DOG	 If the family doesn't adopt the puppies, we will buy collars for them.
IX-2p RULE BREAK fs-TAX NONE (1h)part:indef	 You are breaking the rules if there is no tax.
IX-3p:i SISTER NOT LIKE CHOCOLATE fs-CEREAL	 The sister doesn't like chocolate cereal.
CLASS TOUGH	 Is the class tough?
IX-3p:i fs-JACK (1h)PAY/BUY CAR YESTERDAY DO-DO KIND	 What kind of car did Jack buy yesterday? (Jack bought a car yesterday. What kind was it?)
WANT (2h)ANY+(2h)THING part:indef	 Do you want anything?
FRIEND GO-OUT #WHEN TOMORROW++	 The friend is going out tomorrow.
IX-1p+ LIKE CHOCOLATE DRY-CEREAL (1h)part:indef	 I like chocolate cereal.
MANY CHILDREN fs-PHIL HAVE (1h)part:indef	 How many children does Phil have?
NOW fs-JOHN PAY/BUY (2h)DO-DO BIG POSTER	 What did John buy today? He bought a big poster.
IX-2p WANT NONE/NOTHING2 (1h)part:indef	 You don't want anything?
IX-2p LIKE (nd-1)MOVIE IX-2p	 Do you like movies?
HAVE CLASS2 TOMORROW	 Do you have class tomorrow?
BUY CAR WHO++ (1h)part:indef	nan
KID PLAY-continuative WHERE	 Where are the kids playing?
fs-PHIL (1h)HAVE MANY CHILDREN IX-3p-pl-arc MANY part:indef	 How many children does Phil have?
fs-LUB IX-2p JOIN GROUP/TOGETHER IX-1p WANT2 JOIN IX-1p	 The club you are in, I want to join also.  ("C" cut off from video!)
NOT-MIND++ 2p-HELP-1p	 Do you mind helping me?
IX-1p (1h)PAY/BUY fs-GIFT FOR MOTHER IX-3p:i FUTURE LOVE IX-3p:j	 I bought a gift for my mom. She will love it!
LOOK WARM IX-loc:i MUST GO-OUT fs-BEACH	 When it looks warm out, I must go to the beach.
MOTHER LOOK:i SUSPECT+ BOY+ LIE++	 Mother suspected that the boy was lying.
IX-1p KISS-FIST APPLE DURING/WHILE AUTUMN	 I love apples in the fall.
#IF IX-2p WIN fs-LOTTERY IX-1p-pl-2+:i DEPART ns-JAMAICA	 If you win the lottery, we are going to Jamaica.
#IF IX-3p-pl-arc CHILDREN DYE DCL:5"hair dyed all over" ORANGE POSS-3p:i/j+ MOTHER+FATHER NOT (1h)HAPPY	 If the children dye their hair orange, their parents will not be happy.
CAR+ BREAK-DOWN	 The car didn't breakdown.
WEATHER NOT BEAUTIFUL NOW	 The weather isn't beautiful today.
IX-1p LOOK MOVIE PAST+NIGHT IX-1p AFRAID (1h)WOW/AWFUL	 I watched a movie last night. I was really scared.
MOTHER NICE/CLEAN+ KITCHEN #WHEN	 When did mom clean the kitchen?
IX-3p:i (5)MAN DECIDE WANT+NEG BIG CAR FAVORITE/PREFER SMALL CAR	 The man decided he didn't want a big car; he prefers a small car.
HAPPEN RAIN IX-1p                NOT HAVE UMBRELLA+	 If it happens to rain I won't have an umbrella.
NOW+ (5)WEATHER BEAUTIFUL	 The weather is beautiful today.
NAME CITY/COMMUNITY3 fs-BU WHERE ns-BOSTON fs-BOSTON	 What's the name of the city where BU is? Oh it's Boston?
POSS-1p FRIEND IX-loc:i MOST-SKILLED MAKE (2h)alt.FIRE PUT-AWAY+ WHY LONG-AGO IX-3p:i BOY+SCOUT+	 My friend is an expert at making fires because he use to be a boy scout.
IX-1p NOT BORN HERE IX-1p BORN IX-loc:i DIFFERENT (Y)COUNTRY	 I wasn't born here, I was born in a different country.
(1h)5"wave no" NOT fs-JOHN IX-loc:i IX-3p:j fs-MARY IX-loc:j BREAK-DOWN CAR	 It wasn't John whose car broke down, it was Mary.
IX-3p:i fs-JOHN GO-OUT WITH fs-MARY NOT DRIVE 5"wave no" SCL:U-L"person walking" TO/UNTIL WORK	 When John goes with Mary, they don't drive. They walk to work.
MAYBE TOMORROW RAIN FINISH STOP	 Maybe tomorrow it will stop raining.
POSS-1p BROTHER WORK NIGHT-pl-arc	 My brother works nights.
IX-1p LOVE ACTION MOVIE NOT BORE fs-DRAMA (1h)5"forget it"	 I love action movies, not boring dramas.
HERE ns-BOSTON NEVER SNOW (1h)5"perplexed" 5"wave no" YES SNOW A-LOT IX-3p:i FINISH SPEND COLD HERE PAST+ part:indef	 "It never snows here in Boston." "Yes, it snows a lot in Boston. Have you spent a winter here before?"
IX-3p:i fs-JOHN WORK NIGHT-pl-arc	 John works nights.
NO++ CAR NOT BREAK	 No, the car's not broken.
VEGETABLE IX-loc-pl-arc WHICH KID KISS-FIST WHICH	 Which vegetable do the kids love?
RAIN++ (1h)WOW/AWFUL	 It's raining so much. Wow.
fs-JACK IX-3p:i (1h)HAVE (1h)PAY/BUY QMwg	 Does Jack have money?
NOT RAIN+ part:indef	 It's not raining.
SWIM fs-BEACH IX-3p:i WHO IX-3p:i	 Who is swimming at the beach?
(1h)FISH fs-ANN VOMIT/HATE BUT CHICKEN+ FINE+ ICL:x-over-thumb"eating out of a bowl"	 Ann hates fish but likes chicken.
IX-3p:i FEEL NONE/NOTHING2 (1h)part:indef FEEL (F)NONE/NOTHING2 (1h)part:indef	 He/She really feels nothing?
SORRY SELL IX-loc:i NOT SELL FUNNY BOOK NONE/NOTHING	 Sorry, the store doesn't sell funny books.
CAR+ BREAK-DOWN NOT	 No, the car didn't break down.
FATHER IX-loc:i ARRIVE HOME fs-LATE NIGHT+	 Did Father arrive home late at night?
CAR+ BREAK-DOWN NOT	 The car did not breakdown.
fs-JASON IX-3p:i 5"hands off" GO HOME (25)WHY HOT	 Jason is going home because he is hot.
IX-3p:i fs-JOHN BUY (Y)YESTERDAY "WHAT"	 What did John buy yesterday?
#WHEN fs-BOB PUT-AWAY (2h)alt.FIRE FINALLY IX-1p GRAB-CHANCE GO GATHER DCL:C"logs" WOOD	 When Bob succeeds with making a fire, I will have to collect more firewood.
IX-1p WASHING-MACHINE+ NONE/NOTHING2 part:indef	 I didn't wash my clothes.
EVERYDAY+ IX-3p:i fs-JOHN DRIVE IX-3p:j fs-MARY WORK (1h)part:indef	 John drives Mary to work everyday.
IX-3p:i CAR BREAK part:indef	 The car is broken.
fs-LIZ SISTER IX-3p:i FAMOUS WHO	 Who is Liz's famous sister?
part:indef IX-1p FOLLOW IX-1p NOT fs-CARE part:indef	 I'll follow whatever, I don't care.
fs-JOHN IX-3p:i FUTURE TAKE DRIVE fs-MARY WORK++	 John will drive Mary to work.
DEPART CAMP+ WHO	 Who went camping?
IX-1p SURPRISE IX-1p CANNOT THINK+MARRY NOT RAIN IX-1p WONDER	 I'm surprised. I can't believe it's not raining. I wonder why.
#IF FRIEND IX-loc:i GROUP/TOGETHER DEPART        FUTURE STAY HOME LOOK #TV+	 If the friends don't go out together, they will stay home and watch TV.
WHO BUY FLOWER (1h)part:indef	 Who bought the flowers?
WOW BRACELET+ PRICE MANY+ THREE+THOUSAND	 Wow! That watch costs three thousand dollars!
MAYBE POSS-3p:i CAR HERE	 Maybe his/her car is here.
(5)MAN SCL:X"man walking" SEE MONEY2 IX-3p:i ICL:flat-O"holding money" ICL:flat-O"pocketing money"	 A man walking saw money on the ground, and seeing no one was around, he pocketed it.
BOY WANT NEW SHOE	 The boy wants new shoes.
#IF+ MOTHER 5"forget it" NOT NICE/CLEAN KITCHEN IX-1p+ MUST IX-1p	 If Mom doesn't feel like cleaning the kitchen, I have to do it.
fs-PAUL IX-3p:i i:TELL-1p IX-3p:i CANNOT INTERPRET CAR BREAK-DOWN	 Paul told me he can't interpret because his car broke down.
IX-1p 1p-TELL:i IX-1p FINISH IX-1p GO-OUT TOMORROW	 I already told them that I'm going out tomorrow.
IX-3p:i (5)MAN IX-2p RECENT-PAST MEET IX-loc:i SEARCH-FOR #JOB IX-3p:i	 That man you just met is looking for a job.
IX-1p D CLASS IX-1p ACCEPT	 I got a D in the class; I accepted it.
PAST+ IX-1p LIE NOW IX-1p NOT 5"no more" SORRY+	 I used to lie but I don't anymore. I regret lying.
CAR NOT BREAK part:indef IX-3p:i NONE/NOTHING #GAS part:indef	 The car's not broken, there's just no gas.
#IF IX-3p:i fs-JOHN #DO THAT TO/UNTIL IX-1p FINE RELATIONSHIP-OFF PAST	 If John did that to me, we would have broken it off a long time ago.
POSS-1p MOTHER IX-loc:i NOT UNDERSTAND QUESTION IX-3p:i	 My mom didn't understand the question.
POSS-1p WIFE POSS-3p:i MOTHER+ IX-loc:j EAT IX-1p LIE 1p-TELL:i (1h)GOOD/THANK-YOU REALLY (1h)part:indef	 I lied and told my wife that her mom's food was good when really it wasn't.
RAIN IX-1p NEVER CAN FIND/FIND-OUT UMBRELLA	 I can never find an umbrella when it rains.
#ALL (5)MAN GROUP/TOGETHER DEPART TOGETHER/GO-STEADY	 All the men left together.
CAR IX-3p:i fs-MARY BUY WHEN part:indef	 When did Mary buy the car?
IX-3p:i DECIDE TELL:j fs-JOHN DO-DO+	 What did he/she decide to tell John?
(1h)WOW/AWFUL NOW RAIN 5"forget it" IX-1p GO-OUT	 Wow, it's raining now, whatever, I'm going out still.
ATTENTION-WAVE THINK SHOULD+ (2h)GO-OUT NOW	 Do you think I should leave now?
#IF+ MOTHER+ NICE/CLEAN+ KITCHEN IX-1p-pl CANNOT COOK COOKIE NOW	 If Mother is cleaning the kitchen, we can't bake cookies today.
#IF IX-1p STUDY FUTURE FAIL	 If I don't study, I will fail.
(25)WHY FATHER (P)UPSET (1h)part:indef KNOW+(1h)NEG	 Why is dad upset? I have no idea...
FRIEND GO-OUT WHERE (P)PARTY	 The friend went out to a party.
fs-MARY IX-loc:i VEGETABLE+AGENT	 Mary is a vegetarian.
IF TOMORROW RAIN STOP IX-1p DEPART	 If it stops raining tomorrow, I will leave.
fs-OBAMA IX-3p:i SWIM fs-BEACH IX-3p:i	 Obama was swimming at the beach?
PEOPLE IX-1p MEET PAST+NIGHT IX-loc:i (L-X)INTERESTING (1h)5-C-L"that's the way it is"	 The people I met last night were really interesting!
fs-NETFLIX i:SEND/MAIL-1p IX-1p fs-DVD (2h)(nd-B-L)IX-3p:j 3"come on" SCRATCH "aw man"	 Netflix sent me a DVD but it was scratched.
#IF+ FATHER IX-3p:i ARRIVE HOME fs-LATE NIGHT NOT CAN i:HELP-1p MORE HOME+WORK	 If father doesn't come home late tonight, he can help me with my homework.
(1h)5"hey!" IX-1p+ LIKE PINEAPPLE fs-CREAM+CHEESE IX-1p	 Hey wait, I do like pineapple cream cheese!
(1h)5"wave no" IX-1p USE CORRECT (1h)KEY++ IX-loc:i CAR BREAK-DOWN	 No, I did use the right key. The car is broken.
IX-1p LIKE IX-3p:i CHOCOLATE fs-CEREAL BUT NONE/NOTHING2 (25)WHY part:indef	 I like chocolate cereal but there isn't any. Why is that?
IF+ (5)WEATHER WARM IX-1p-pl-arc GO fs-BEACH	 If the weather is warm, we are going to the beach.
fs-PETE IX-3p:i (2h)KNOW+NEG HOW USE COMPUTER2 part:indef #NO+ (1h)5"wave no" IX-3p:i EXTENSIVE-KNOWLEDGE IX-3p:i HAVE THREE COMPUTER #AT HOME (1h)part:indef	 "Pete doesn't know how to use a computer." "No, Pete is a genius. He has three computers at home."
CAR IX-3p:i REALLY+WORK+ BREAK-DOWN IX-3p:i	 The car really broke down.
NICE/CLEAN+ KITCHEN WHO	 Who cleaned the kitchen?
WHO BUY FLOWER (1h)part:indef	 Who bought flowers?
IX-2p GRADUATE #HS #WHEN IX-2p FUTURE GO COLLEGE IX-2p	 When did you graduate high school? Will you go to college?
FRIEND GO-OUT NOW+ WHY+ IX-3p:i BORE	 The friend is leaving now because he/she is bored.
IX-3p:i (1)GUILTY+ NONE/NOTHING2+ part:indef	 He/She isn't guilty.
REALLY POSS-1p+ OPPOSITE FRIEND DO-DO+ ALARM+	 My worst enemy is my alarm clock.
PEOPLE+ REFUSE LEAVE part:indef	 No, people won't leave.
RECENT-PAST RAIN NONE/NOTHING2+	 It hasn't rained recently.
fs-MARY FINISH BORN BABY GIRL+ FINISH	 Mary had a baby girl.
5"wave no" PINEAPPLE fs-CREAM CHEESE 5"wave no" BETTER fs-LOX IX-1p 5"hands off"	 No, not pineapple cream cheese. Lox is better for me, that's it.
IX-pl-2:i/j fs-JOHN fs-MARY (1h)HAVE STRANGE BICYCLE SCL:crvd-V?two people on tandem bicycle?	 John and Mary have a strange bike. Two people can ride on it.
FAMILY IX-3p:i TAKE-UP DCL:crvd-B"small puppies" #DOG QMwg	 Did the family adopt small puppies?
#IF+ MOTHER NOT SCL:bent-U-L"person walking" SELL+ part:indef NONE/NOTHING MILK part:indef	 If mom doesn't walk to the store, there won't be any milk.
IX-1p OFFICE POSS-1p BOSS WORK ABOVE IX-loc+:i	 My boss works in an office right above me.
fs-MARY GO-OUT FARM+ BUY #FRESH BUTTER+	 Mary goes to the farm to buy fresh butter.
WEATHER NOT LOUSY NOW FINE+	 The weather today isn't lousy, it's fine.
MOVIE IX-3p:i QUOTE/TOPIC fs-ELECTION IX-3p:i STRANGE BUT FUNNY part:indef	 That movie, Election, is weird but it's funny.
IX-1p NOTHING-AT-ALL CAR part:indef	 Nope, I don't have a car.
IX-1p MONEY+ IX-1p NOTHING-AT-ALL IX-1p part:indef	 I have no money.
FATHER+ IX-3p:i LIKE PINEAPPLE fs-CREAM+CHEESE i:SAME-1p+	 My dad likes pineapple cream cheese, like me.
WHO BUY CAR part:indef	 Who bought the car?
(1h)5"wave no" NOT fs-JOHN IX-3p:i fs-MARY BREAK fs-TRUCK IX-3p:j	 No, John didn't break the truck, Mary broke the truck.
WHEN FATHER ARRIVE HOME fs-LATE NIGHT MOTHER REFUSE MAKE EAT+NIGHT+	 When father arrives home late, mother refuses to make dinner.
IX-1p KNOW+ IX-3p:i READ MANY BOOK	 I know he/she reads a lot of books.
#NO IX-1p NOT LIKE PINEAPPLE fs-CREAM CHEESE #NO	 No! I don't like pineapple cream cheese.
IF+ IX-1p FORGET GO SELL+ POSS-1p MOTHER+ UPSET FUTURE	 If I forget to go to the store, my mother will be upset.
fs-SUE fs-BEN DECIDE MOVE ns-BOSTON ARRIVE (1h)LAST-YEAR+	 Sue and Ben decided to move here to Boston. They arrived last year.
(1h)WOW/AWFUL SOMETHING/ONE TELL-1p PRESIDENT (1h)MAYBE FIRED 5-C-L"I don't know"	 Wow, someone told me that the president might get fired.
IX-3p:i FUTURE (1h)(flat-O)PAY/SPEND IX-3p:j FLOWER FOR REALLY YES+	 He/She will buy flowers for you, for sure.
IX-1p 1p-INFORM:i fs-DAN IX-3p:i INTERPRET MUST STAND+ CANNOT SIT	 I told Dan that when he inteprets he has to stand; he can't sit.
IX-1p+ KISS-FIST fs-LOX fs-CREAM+CHEESE IX-1p	 I love lox cream cheese.
PAST+ALL-NIGHT IX-1p #DO HOMEWORK 5"wow" A-LOT	 Last night I did a lot of homework.
POSS-1p+ NEXT-TO2 RECENT-PAST TAKE-UP DCL:crvd-B"small puppies" DOG (25)WHY RECENT-PAST (1h)HAVE KID	 My neighbor recently adopted puppies because she just had children .
WHICH TEAM IX-3p:i WIN NOW IX-3p:i FUTURE NEXT GAME IX-3p:i	 Whichever team that wins this game will move onto the next game.
PAST+NIGHT (5)ACCIDENT PCL:5"long line of cars" (1h)WOW/AWFUL	 Last night, there was an accident and traffic was horrible.
POSS-3p:i FATHER GO-OUT 5"perplexed"	 His/Her father left.
PERSON ARRIVE LATE+ WHO	 Who arrived late?
MOTHER+ IX-3p:i (1h)HATE/VOMIT SURPRISE IX-3p:i	 Mom hates surprises.
fs-JOHN IX-loc:i NOT SEE IX-1p NONE/NOTHING	 John didn't see me.
WHEN FATHER ARRIVE HOME fs-LATE NIGHT+ MOTHER UPSET (2h)alt.ANGRY+++	 When father arrives home late at night, mom is upset and angry.
FATHER+ REPAIR2 TIME++DCL"circular object" HOW++	 How did Father fix the clock?
GAME+ FINISH SIX QMwg	 Does the game end at six?
BOY LIE++ BLAME+ IX-3p:i fs-DOG IX-3p:i	 The boy lied and blamed the dog.
IX-3p-pl-2:i/j fs-MARY fs-JOHN FUTURE DEPART TOMORROW	 Mary and John will leave tomorrow.
#IF SWIM IX-1p WANT+NEG FUTURE DO-DO SCL:bent-U-L"person walking"	 If I don't want to swim, I will walk along the edge of the water.
IX-1p WANT+NEG SOMETHING/ONE IX-1p (1h)5"wave no"	 I don't want anything.
FOR REALLY IX-3p:i FUTURE BUY IX-3p:j FLOWER YES++	 He will buy flowers for sure.
NOW-WEEK IX-1p SAVE-MONEY MONEY+	 This week I didn't save money.
IX-3p-pl-arc AGREE	 Do you all agree?
NOT (1h)HAVE (1h)(flat-O)PAY/SPEND NONE/NOTHING2++	 I don't have any money.
IX-1p FUTURE SERVICE NUT BUTTER (2h)#ALL2 LIKE PERFECT 5"wave no" IX-3p:i fs-BETH 5"whoa" ALLERGY CANNOT EAT NUT BUTTER 5"wave no"	 "We will serve peanut butter to everyone that likes it." "No, Beth is allergic to peanut butter. She can't eat it so we can't serve it."
IX-3p:i CAR NOT BREAK-DOWN 5"wave no" IX-3p:j fs-TRUCK BREAK-DOWN	 The car didn't break down, the truck did.
POSS-1p FRIEND i:TELL-1p IX-3p:i BORN ns-CHICAGO	 My friend told me she/he was born in Chicago.
NOT BUY CAR INSURANCE/INFECTION FOR-FOR part:indef	 Why didn't you buy car insurance?
LIBRARY LEND MAGAZINE QMwg	 Does the library lend out magazines?
LIBRARY (1h)HAVE MANY MAGAZINE	 The library has a lot of magazines.
WHEN MOTHER SCL:bent-U-L"person walking" SELL+ IX-1p 5"oh no!" INFORM MUST MILK	 When mom walks to the store, I let her know we need milk.
(B)WHY++ CHOCOLATE DRY-CEREAL NONE/NOTHING part:indef	 Why isn't there any chocolate cereal?
WHO (1h)STEAL MONEY2 (1h)part:indef fs-HARRY IX-loc:i	 Who stole the money? Harry stole the money.
#IF+ IX-1p NONE/NOTHING BOOK READ IX-1p NONE/NOTHING IX-1p BORE IX-1p part:indef	 If I don't have a book to read, I get bored.
IX-1p BABY BORN IX-1p WANT (1h)GIFT:i ns-IRELAND NAME BUT IX-3p:j IX-1p FATHER IX-loc:j (1h)WANT (1h)GIFT:i ns-ITALY NAME+ part:indef	 If I have a baby, I want to give it an Irish name but the father wants to give it an Italian name.
POSS-1p BROTHER IX-3p:i CANNOT i:HELP-1p part:indef	 My brother can't help me.
BLACK BICYCLE IX-loc:i BETTER BUT RED BICYCLE IX-loc:j CHEAP+(1h)MOST part:indef	 The black bike is better but the red bike is cheaper.
(25)WHY IX-loc:i PINEAPPLE CHEESE NONE/NOTHING2 part:indef	 Why isn't there any pineapple cream cheese?
TEACH+AGENT DISTRIBUTE ANSWER TO/UNTIL TEST	 The teacher gave out the answers to the test.
LONG-AGO+ POSS-3p:i fs-MARY NAME DO-DO+	 What did Mary's name used to be?
POSS-1p SISTER ACTION STRANGE IX-1p 1p-LOOK:i	 I noticed my sister acting strange.
IX-loc:i ns-SEATTLE RAIN++ WHEN part:indef EVERYDAY+ (1h)part:indef	 When does rain in Seattle? It rains there everyday.
PAST+NIGHT IX-1p fs-RENT MOVIE WOW/AWFUL (1h)5"forget it"	 Last night I rented an awful movie.
LIKE PINEAPPLE fs-CREAM+CHEESE IX-1p (1h)part:indef	 I do like pineapple cream cheese.
MOTHER+ IX-3p:i LIKE SURPRISE	 Mom likes surprises.
CAR NOT BREAK-DOWN IX-3p:i WRONG KEY2 QMwg	 The car isn't broken. Are you using the wrong key?
IX-2p WRONG IX-1p FAVORITE/PREFER fs-LOX NOT LIKE PINEAPPLE fs-CREAM CHEESE	 You are wrong. I prefer lox, I don`t like pineapple cream cheese.
PUT-AWAY (2h)alt.FIRE WHO	 Who is feeding the fire?
fs-LOTTERY IX-loc:i SOMETHING/ONE WIN QMwg	 Did someone win the lottery?
WARM WEATHER+ REFUSE SNOW part:indef	 If there is warm weather then there won't be snow.
FRIEND DEPART CAMP+	 Did the friends go camping?
IX-1p BELIEVE UP-TO-NOW (2h)NOT-YET DECIDE part:indef	 I can't believe there has not been a decision yet.
IX-3p:i MALE-COUSIN fs-JOHN IX-loc:i BREAK-DOWN CAR REMEMBER IX-2p	 Cousin John's car broke down, do you remember?
IX-3p:i WANT NONE/NOTHING2 DOUBT IX-1p NONE/NOTHING2 (2h)5"dismissive gesture"	 I doubt that he/she wants anything.
IX-1p NOT WANT GO-OUT RAIN+ NOW part:indef	 I don't want to go out; it's raining now.
#IF IX-2p SPELL ONE WORD MISTAKE IX-3p:i FUTURE WRITE SUBTRACT	 If you spell even one word wrong, he will take away points for it!
IX-1p CANNOT BELIEVE fs-JOHN NOT BUY TURKEY 5"exasperation"	 I can't believe John didn't buy the turkey.
IX-1p+ NOT STUDY IX-1p GUARANTEE FAIL IX-1p	 When I don't study, I am guaranteed to fail.
IX-loc:i fs-MARY LIKE fs-MARGARINE NOT LIKE BUTTER+	 Mary likes margarine but she doesn't like butter.
FRIEND IX-3p:i DO-DO+++ part:indef	 What did the friend do?
fs-BILL MOVE ns-NEW-YORK QMwg	 Did Bill move to New York?
WHICH COLLEGE fs-MARY GO-OUT WHICH (1h)part:indef	 Which college does Mary go to?
ROOMMATE GO-OUT TOGETHER/GO-STEADY2 QMwg	 Did the roommates go out together?
WEATHER IX-3p:i NOT BEAUTIFUL NOW+ 5"oh well"	 The weather isn't beautiful today. Oh well.
IX-1p+ NOT LIKE PINEAPPLE fs-CREAM+CHEESE IX-1p	 I don't like pineapple cream cheese.
LONG-AGO fs-JOHN EVERYDAY TAKE-continuative fs-MARY GO WORK+	 John used to take Mary and drive her to work every day.
NEAR+ LAST SEMESTER IX-1p (5)SOCIAL/INTERACT IMPOSSIBLE+++	 When it's near the end of the semester, it's impossible to hang out.
fs-MARY IX-3p:i NOT VEGETABLE #NO+	 No, Mary is not a vegetarian.
IX-1p LIKE MAYBE (2h)THING (2h)ANY+(2h)THING (2h)5"I don't know"	 It doesn't matter to me. I like anything.
SOMETHING/ONE BUY CAR WHO part:indef	 Someone bought the car. Who was it?
IX-2p GO (P)PARTY NEXT-WEEK IX-2p	 Are you going to the party next week?
CAR BREAK-DOWN YES+	 Yes, the car is broken down.
IX-1p (2h)KNOW+NEG NOT PERMIT SIT TABLE SORRY 5"hands off"	 I didn't know that I was not allowed to sit on the table, I'm sorry.
IF IX-3p:i ALLERGY NUT+ 5"wave no" CANNOT EAT SHEET-CAKE IX-3p:j	 If he is allergic to peanuts, he cannot eat the cake.
IX-3p:i FARM NAME fs-ROBERTS fs-RANCH	 The name of the farm is Roberts Ranch.
#ALL2 LEARN+AGENT ARRIVE ON TIME NONE TEST	 If all the students arrive on time, there won't be a test.
IX-2p WRONG IX-3p:i NOT PINEAPPLE fs-CREAM CHEESE IX-1p FAVORITE/PREFER fs-LOX	 You're wrong, that is not pineapple cream cheese. I prefer lox.
#IF IX-3p:i PINEAPPLE fs-CREAM CHEESE (1h)5"wave no" IX-1p REFUSE EAT+ fs-BAGEL (1h)5"wave no"	 If that is pineapple cream cheese then I won't eat the bagel.
NEXT-WEEK fs-PAUL BUSY ALL-DAY WORK INTERPRET+ NIGHT-pl-arc CLASS-pl (1h)WOW/AWFUL	 Next week, Paul will be very busy. He works as an interpreter all day and takes night classes.
fs-JOHN IX-3p:i NOT BREAK fs-TRUCK IX-3p:i IX-3p:i REALLY WORK+ DESTROY CAR+	 John didn't break the truck, he actually destroyed the car.
IX-1p TELL:i TOMORROW+ FUTURE RAIN++	 I told him/her tomorrow it would rain.
fs-JOHN IX-3p:i NOT BREAK WINDOW #NO+ IX-3p:j fs-SALLY	 John didn't break the window, Sally did.
SOUP fs-GAZPACHO SOUP IX-3p:i COLD NOT HOT (1h)5"why is it so"	 The soup, gazpacho soup, is cold not hot.
IX-3p:i POSS-1p SON i:TELL-1p FAVORITE/PREFER BLACK PANTS2 part:indef	 My son told me that he prefers black pants.
IX-2p FUTURE SEE IX-2p fs-MARY IX-3p:j (P)PARTY2 NOT-MIND TELL:j j:CALL-1p (1h)part:indef #NO IX-1p DOUBT FUTURE GO-OUT IX-loc:k BUT #IF IX-1p SEE:j IX-2p IX-1p FUTURE TELL:i CALL:k 5"of course"	 You'll see Mary at the party. Would you tell her to call me? I doubt that I'll be going out but if I see her I will tell her to call you.
IX-3p:i NOT POSS-1p #DOG+ IX-3p:i	 That dog isn't mine.
PLAY-continuative fs-PARK IX-3p:i WHO IX-3p:i	 Who is playing at the park?
MOTHER NICE/CLEAN+ KITCHEN	 Did mother clean the kitchen?
BORN fs-SEPT WHO POSS-1p BROTHER AND FATHER IX-3p-pl-2:i/j	 Who was born in September? My brother and my father.
ARRIVE fs-LATE FINE IX-1p MUST CALL-BY-PHONE IX-3p:i RESTAURANT POSTPONE APPOINTMENT	 If you're arriving late, it's fine. I just have to call the restauarnt and postpone the reservation.
#IF IX-2p (1h)WANT WALK+ CAN WALK+ IX-loc:i fs-PARK	 If you want to walk, you can walk to the park.
IX-1p KNOW+ IX-3p:i FINISH READ BOOK	 I know that he/she finished reading the book.
IX-3p:i LONG-AGO+ ACCEPT BIG2 BOAT2	 He/She used to own a big boat.
LAST-WEEK fs-JOHN ARRIVE fs-LATE 5"frustration"	 Last week John arrived late.
FRIEND IX-loc:i DO-DO+ IX-3p:i	 What did the friend do?
MOTHER COME MUST NICE/CLEAN+ HOUSE	 If mom comes, I have to clean the house.
IX-3p-pl-arc GIRL+ ARRIVE ON-TIME	 Did those girls arrive on time?
#IF+ FATHER ARRIVE HOME fs-LATE NIGHT+ MOTHER FUTURE BAWL-OUT+:i WHY++ IX-1p GRAB-CHANCE IX-1p-pl-circle SEE CHILDREN IX-1p-pl-arc BEFORE2 BED part:indef	 If father arrives home late tonight, mom will yell at him because he would have missed the chance to see his children before bed.
TEACH+AGENT REQUIRE fs-JOHN IX-3p:i FUTURE READ BOOK+	 If the teacher requires John to do it,  John will read the book.
IX-2p KNOW+ PRESIDENT ARRIVE (Y)YESTERDAY	 Did you know the president arrived yesterday?
GO-OUT NONE/NOTHING2 RAIN (1h)WAIT WAIT-A-MINUTE	 It's not raining outside. Oh,wait a minute.
CAR+ part:indef BREAK part:indef	 I can't believe the car broke!
fs-OBAMA IX-loc:i SWIM fs-BEACH	 Obama is swimming at the beach?
WHO VISIT ns-BOSTON (Y)YESTERDAY WHO POSS-1p (R)BEST-FRIEND GO	 My best friend visited Boston yesterday.
IX-3p:i SUMMER+ BLACK DRESS/CLOTHES+ HOT	 Wearing black clothes in the summer will make you hot.
MOTHER IX-loc:i FINISH GO SCL:bent-U-L"person walking" SELL++	 Did mother already walk to the store?
fs-JOHN IX-loc:i BREAK WINDOW+	 John broke the window.
SORRY BLACK SHOE GONE FINISH part:indef	 Sorry, the black shoes are gone.
i:SAME-1p IX-3p:i #IF IX-3p:j HAVE PINEAPPLE fs-CREAM CHEESE IX-1p REFUSE EAT fs-BAGEL i:SAME-1p	 I agree with you. If that's pineapple cream cheese then I won't eat the bagel.
WHO FIND/FIND-OUT POSS-1p KEY2 WHO	 Who found my keys?
IX-1p MUST TAKE-UP TEST AGAIN	 I have to take the test again.
ARRIVE HOME fs-LATE NIGHT+ WHO	 Who arrived home late at night?
IX-1p CANNOT BELIEVE IX-3p:i GUILTY+ #NO+	 No, I can't believe he/she is guilty.
IF IX-2p INTERPRET IX-2p MUST USE BLACK DRESS/CLOTHES	 If you are going to interpret, you must wear black clothes.
DRIVE+ TIRE (1h)FLAT-TIRE3 (2h)IX-1p 5"panic" CALL-BY-PHONE fs-AAA GO VERY-FAST	 I was driving and I got a flat tire, so I called AAA and they came very quickly.
LONG-AGO+ fs-JOHN TEND DRIVE+ IX-3p:i fs-MARY TO/UNTIL WORK (1h)TEND	 In the past, John usually drove Mary to work.
IX-1p THINK fs-OBAMA FUTURE WIN AGAIN part:indef	 I think Obama will win again.
MAYBE IX-1p-pl-2:i SCL:V/2"two of them go together" TOMORROW+ part:indef	 Maybe we can leave tomorrow.
TOMORROW FAMILY GO WHERE	 Where is the family going to tomorrow?
FRIEND GROUP/TOGETHER DEPART IX-1p JOIN	 If my friends leave together, I will join.
GO-OUT+ NOT SNOW SCHOOL OF-COURSE NOT CANCEL/CRITICIZE	 If there's no snow outside then of course school isn't cancelled.
FATHER ARRIVE HOME fs-LATE NIGHT+	 Father arrived home late at night.
POSS-2p SISTER NOT LIKE PINEAPPLE fs-CREAM+fs-CHEESE (1h)part:indef	 Your sister doesn't like pineapple cream cheese.
FRIEND IX-loc:i DEPART CAMP+	 Did the friends go camping?
ALCOHOL+ SELF-3p+:i NOT ALWAYS (1h)GOOD/THANK-YOU part:indef	 Alcohol is not always good.
IX-1p NOT STUDY REALLY+WORK fs-POP #QUIZ	 There is always a pop quiz on the days I choose not to study.
IX-2p WANT IX-1p CAN WORK+ WITH	 If you want, we can work together.
SORRY MUST WAIT SIT++ IX-loc:i	 I'm sorry, you have to wait. Sit over there.
fs-JOHN DRIVE TO/UNTIL fs-MARY NOT WORK (1h)5"wave no" TO/UNTIL SCHOOL+	 John drives Mary to school, not work.
IX-3p-pl-2:i/j fs-JACK fs-SUE MEET PAST+ FINISH QMwg	 Did Jack and Sue already meet?
MOVIE2 START TIME+ SEVEN	 The movie starts at 7.
fs-JOHN TAKE fs-MARY DRIVE WORK+ EVERYDAY	 John took Mary and drove her to work every day.
#IF+ IX-1p LOOK-DOWN fs-BEACH CROWDED IX-1p 5"forget it"	 If I see that the beach is crowded, I won't go.
IX-3p:i FINISH DECIDE DO-DO+	 What did he/she decide?
HOMEWORK IX-1p FINISH PAST+NIGHT IX-1p	 I finished homework last night.
5"wave no" IX-1p NONE/NOTHING2 CAR	 No, I don't have a car.
(1h)NOW+NIGHT IX-1p GO-OUT MOVIE	 Tonight, I'm going to a movie.
IX-1p STUDY NOW-WEEK FOR TEST	 I'm studying this week for the test.
FRIEND GO-OUT TOGETHER/GO-STEADY2 QMwg	 Did the friends go out together?
(1h)INFORM-2p IX-3p:i CAR BREAK-DOWN IX-1p USE2 CORRECT KEY2	 I'm letting you know that the car is broken down, I used the the right key.
NONE/NOTHING (2h)alt.SEARCH-FOR FIND/FIND-OUT MONEY+ NONE/NOTHING+ part:indef	 Nobody is looking to find money.
NOW HOMEWORK NONE/NOTHING2++	 There is no homework today.
fs-JOHN IX-3p:i NOT BUY TURKEY (1h)part:indef	 John didn't buy the turkey.
CAR+ BREAK-DOWN (1h)5"wave no" #NO+++	 No, the car didn't breakdown.
POSS-1p SISTER i:BLAME-1p IX-1p 5"exasperation" IX-1p INNOCENT 5"exasperation"	 My sister blamed me but I am innocent!
PICTURE IX-2p 2p-GIVE-1p WOW BEAUTIFUL	 That picture you gave me was beautiful.
FOR REALLY IX-3p:i FUTURE i:(1h)GIFT:j FLOWER	 He/She will for sure give him/her flowers.
POSS-1p MOTHER+ IX-3p:i BECOME OLD (1h)part:indef	 My mom is getting old.
IX-1p REALLY HAVE PINEAPPLE fs-CREAM CHEESE	 I really do have pineapple cream cheese.
AIRPLANE IX-loc:i KICK-OUT WHO IX-3p:j fs-ALEC-BALDWIN	 Who was kicked out of the plane? Alec Baldwin.
SORRY LIBRARY IX-loc:i CANNOT LEND MAGAZINE MUST STAY READ+	 Sorry, the library doesn't let you borrow magazines. You have to stay here and read them.
IX-1p NOT	 I'm not.
IX-1p (1h)5"forget it" STUDY+ ALWAYS HIT fs-POP #QUIZ SICK/SILLY (1h)part:indef	 There's always a pop quiz when I neglect my studying.
POSS-1p-pl COUSIN fs-JOHN IX-3p:i BREAK IX-3p:j fs-TRUCK IX-loc:j	 Our cousin, John, broke the truck.
IX-1p SON IX-3p:i WANT INTERPRET FUTURE IX-3p:i	 My son wants to be an interpreter.
FATHER LOOK:i BOY SMIRK NOT SEEM SORRY (1h)part:indef	 Father watched the boy smirk and it didn't seem like the boy was sorry.
HAPPEN IX-1p NONE/NOTHING2+ MONEY++ IX-1p TEND GO AUNT HOUSE EAT+ IX-loc:i	 When I don't have money, I tend to go to my aunt's and eat there.
fs-JOE IX-3p:i INTERPRET (1h)GOOD/THANK-YOU SKILL (1h)part:indef	 Joe is a good interpreter, but he isn't proficient.
UP-TO-NOW fs-MARY IX-3p:i POSS-3p:i CAR BREAK IX-3p:i fs-JOHN TAKE-continuative WORK+	 Since Mary's car broke, John has been taking her to work.
IX-3p:i fs-JOHN WORK LIBRARY	 John works at the library.
MAYBE IX-3p-pl-2:i/j fs-JOHN fs-MARY DECIDE WORK WITH NOW part:indef	 Maybe John and Mary will decide to work together now.
HAPPEN IX-3p:i fs-MARY CAR BREAK-DOWN TEND IX-3p:j fs-JOHN DRIVE TO/UNTIL WORK	 When Mary's car breaks down, John usually gives her a ride to work.
COMPARE fs-LAKE              IX-1p+ FAVORITE/PREFER+ IX-3p:i fs-BEACH WHY IX-3p:i HAVE OCEAN IX-3p:j fs-LAKE NONE/NOTHING part:indef	 I prefer the beach to the lake because it has waves and the lake does not.
IX-1p DRINK WATER IX-3p:i TASTE FUNNY (1h)5"perplexed" #NO TASTE OF-COURSE TO/UNTIL IX-1p (2h)"I don't know"	 "The water I drank tasted funny." "No it tastes normal to me."
NAME+ CITY/COMMUNITY3 fs-BU part:indef ns-BOSTON part:indef fs-BUSTUN fs-BOSTON	 What's the name of the city where BU is? Bustun? No, it's Boston.
GO-OUT+ NOT SNOW SCHOOL OF-COURSE OPEN STAY++	 If there's no snow outside, of course school will be open.
TEACH+AGENT NOT REQUIRE BOOK READ DROP IX-3p:i fs-JOHN FUTURE READ BOOK (2h)B-L:"I don't know"	 The teacher didn't make the reading required. It's uncertain whether or not John will read the book now.
DATE/DESSERT+ IX-1p+ FAVORITE/PREFER+ MELON/PUMPKIN+ PIE	 My favorite dessert is pumpkin pie.
MOTHER IX-3p:i DEAF SOMETIMES POSS:i DAUGHTER INTERPRET FOR IX-3p:i MOTHER+	 Mother is deaf and sometimes her daughter interprets for her.
fs-MARY LONG-AGO+ (L)LIVE ns-BOSTON	 Mary used to live in Boston.
IX-1p NONE/NOTHING2 READ2 IX-1p FUTURE BORE	 If I don't read, I will be bored.
#NO+ IX-1p VOMIT+ #IF PINEAPPLE fs-CREAM CHEESE ONLY IX-3p:i fs-LOX IX-1p FINE+	 No, I wouldn't stop vomiting if I had pineapple cream cheese. Lox only is fine with me.
IX-3p:i fs-DOG i:CHASE:j IX-3p:j CAT IX-loc:j DOG IX-loc:j NOT POSS-1p+ 5"wave no"	 The dog that was chasing the cat is not my dog.
BOY PUT-AWAY+ (2h)alt.FIRE++	 A boy is feeding the fire.
IX-1p WANT THAT:i IX-3p:i BLACK BOOK IX-loc:i	 I want that black book.
IX-3p:i FINALLY LEARN HONEST FUTURE FEEL DISGUST+	 Once he learns the truth, he will be disgusted.
CAR+ BREAK-DOWN	 The car broke down.
NEW STUDENT UP-TO-NOW NONE/NOTHING MEET NONE/NOTHING++	 So far, no one has approached the new student.
TEACH+AGENT IX-3p:i REQUIRE IX-3p:j fs-JOHN MUST READ+ BOOK	 The teacher made the reading required for John so he had to read the book.
KID PLAY-continuative IX-loc:i fs-PARK	 The kids are playing at the park.
IX-1p CANNOT BELIEVE IX-3p:i NOT GUILTY IX-1p THINK IX-3p:i GUILTY+	 I can't believe he/she is not guilty. I thought he/she was guilty.
IX-1p GO fs-TJ IX-1p MUST BUY ORANGE JUICE	 When I go to Trader Joe`s, I must buy orange juice.
SUMMER HOT fs-DAY IX-3p:i fs-MARY KISS-FIST DRINK LEMON+	 On hot summer days, Mary loves drinking lemonade.
#IF+ FRIEND GROUP/TOGETHER DCL:crvd-5"group-go-together" CAMP+ IX-1p+ JOIN	 If a group of friends go camping together, I will join them.
THAT BOOK IX-2p READ IX-loc:i IX-1p READ2 IX-3p:i LONG-AGO IX-1p YOUNG++ IX-1p	 That book you are reading now, I read a long time ago when I was young.
MOTHERwg GO-OUT BUY+ WHY+++ MUST BUY+ EAT++	 Mom is going out shopping because she needs to buy food.
VOLUNTEER/SHIRT+ IX-3p-pl-arc NOT CLEAR WHO IX-3p:i IX-3p:j WIN IX-3p-pl-arc part:indef	 It could be a tie. It's not clear who really won.
IX-1p TIRED	 I'm tired.
fs-LOTTERY GET-TICKET WHO WIN WHO	 Who won the lottery?
IX-1p NOT STUDY FUTURE FAIL	 If I don't study, I will fail.
IX-1p NOT ARRIVE #LATE IX-1p ON-TIME IX-1p	 No, I wasn't late; I arrived on time.
#IF PLAN++ UP-AHEAD TIME CAN SAVE MONEY+	 If you plan ahead of time you can save money.
IX-3p:i STRUGGLE-continuative IN SCHOOL BECOME (5)DEPRESS	 When he struggled a lot in school, he became depressed.
LAST-WEEK IX-1p TEST IX-1p B (1h)part:indef	I got a B on last week's test.
CAT IX-3p:i (1h)HAVE NEXT-TO FIND/FIND-OUT IX-3p:j REALLY HUNGRY/WISH (1h)WOW/AWFUL	 The cat the neighbors found is really hungry. Wow.
IF+ HAPPEN EMERGENCY+ IX-2p GO WHERE part:indef	 If there's an emergency, where will you go?
NOW COLD IX-1p MUST BETTER SHOE+	 Now that it's cold, I need better shoes.
fs-JOHN TAKE fs-MARY DRIVE WORK+	 John got Mary and drove her to work.
(1h)GOOD/THANK-YOU+NIGHT	 Good night
MOTHER+ IX-3p:i LIKE SURPRISE IX-3p:i	 Mom likes surprises.
MOTHER NOT LIKE SURPRISE	 Mom doesn't like surprises.
TEACH+AGENT UPSET WHY++ (1h)part:indef	 Why is the teacher upset?
IX-1p MUST FIND/FIND-OUT (1h)"WHAT" GIFT FOR MOTHER+ (1h)part:indef	 I must find a gift for my mom.
IF INTERPRET ARRIVE STRANGE SITUATION	 If an interpreter comes, it will be a strange situation.
STUDENT (1h)GO fs-QUIZ #TV ACT IX-3p:i NOT WIN 5"that's the way it is"	 A student went on a quiz TV show, but he didn`t win.
MOTHER #OK-1p IX-1p GO-OUT GUITAR IX-1p THRILL/WHAT'S-UP	 If my mom says I can go to the concert, I'll be thrilled.
IX-3p:i fs-MARY CAR BREAK-DOWN FINE+ IX-3p:j fs-JOHN DRIVE IX-3p:i TO/UNTIL WORK	 Mary's car broke down. It's fine because John will drive her to work.
FATHER ARRIVE HOME fs-LATE NIGHT+ WHY IX-3p:i RECENT-PAST FINISH POSS-3p:i WORK+	 Father arried home late beacuse he just finished his work.
fs-BOB IX-loc:i WORK BICYCLE SELL+ IX-3p:i	 Bob works at the bike store.
IX-2p FINGERSPELL+ LOUSY (1h)INFORM:i	 Just so you know, your fingerspelling is lousy.
RAIN IX-2p FAVORITE/PREFER DRIVE	 It's raining. Would you prefer driving?
IX-2p SAY (1h)WANT PUNISH PROCEED NOT DISMISS (1h)5"wave no"	 You said you wanted to punish him/her so go ahead don't dismiss it.
BOY+ ARRIVE HOME	 The boy arrived home.
CAR+ IX-loc:i REALLY+WORK+ BREAK part:indef	 The car is really broken!
IX-3p:i fs-KEY FIND/FIND-OUT IX-3p:i WHO+	 Who found the key?
MOVIE QUOTE/TOPIC IX-loc:i VOTE+ fs-ELECTION IX-3p:i (1h)GOOD/THANK-YOU FUNNY #DO++ part:indef	 Was the movie Election any good? Is it funny?
VOLUNTEER/SHIRT+ IX-3p:i WIN REPUBLICAN CLASS2 IX-3p:i FUTURE COMPETITION++ AGAINST fs-OBAMA NEXT VOTE++	 The candidate who wins the Republican primary will run against Obama in the next election.
(5)WOMAN IX-3p:i MARRY PRINCE fs-CHARLES IX-3p:j SON IX-3p:k NOW IX-3p:i (5)WOMAN FAMOUS IX-3p:i	 The woman who married Prince Charles`s son is famous now.
(1h)5"wow" POSS-3p:i FRIEND REALLY ADULT-TALL MAN2	 Wow, his/her friend is a tall man.
CAR IX-3p:i HAVE #GAS FINISH-shake CHECK	 The car has gas, I already checked.
HUNGRY/WISH HAVE PINEAPPLE fs-CREAM CHEESE	 I wish there was pineapple cream cheese.
ONE-DOLLAR++ IX-1p NONE/NOTHING IX-1p part:indef	 I don't even have one dollar!
A-LOT HOMEWORK +	 Is there a lot of homework?
NONE+ WANT GO-OUT part:indef	 No one wants to go.
IX-3p:i (5)MAN FINISH DECIDE READ BOOK TOMORROW	 The man decided to read a book tomorrow.
#IF+ fs-BOB SUCCEED PUT-AWAY DCL:S/5"fire starting" (2h)alt.FIRE IX-1p MUST (2h)LOOK-DOWN	 If Bob is successful with the fire, I will have to watch it.
LIKE PINEAPPLE fs-CREAM CHEESE	 I like pineapple cream cheese.
IX-1p LIKE BUTTER IX-3p:i IX-3p:i fs-LAND-O-LAKES	 I like Land O' Lakes butter.
MOUSE/FICTION ESCAPE SCL:1"mouse scurries" CAT SCL:crvd-V"cat chases mouse" CHASE SCL:crvd-V"cat jumps up onto the table" TABLE	 The mouse escapes and the cat runs after it. The cat is chasing the mouse and the cat jumps onto the table.
IX-2p (1h)GO LOOK MOVIE2 LOOK OH-I-SEE+ FUTURE KNOW+ IX-3p:i FAMOUS ACT+           IX-2p	 When you watch that movie, you will remember that famous actor.
FRIEND IX-3p:i DEPART CAMP+	 The friends go out camping.
POSS-1p FRIEND (Y)WOW THRILL/WHAT'S-UP "WHAT" WIN fs-LOTTERY IX-3p:i	 My friend is thrilled because he won the lottery.
KEY2 IX-loc:i IX-1p HAVE CORRECT FOR CAR A-OK IX-3p:i	 I have the right key.
TWO PLUS ONE EQUAL SIX #NO+ TWO PLUS ONE EQUAL THREE	 Two plus one equals six. No, two plus one equals three.
IX-1p KNOW IX-3p:i FINISH i:TELL-1p PAST+ FINISH	 I know, he/she already told me.
EVERYDAY+ IX-3p:i fs-JOHN DRIVE IX-3p:j fs-MARY TO/UNTIL WORK (1h)part:indef	 Everyday, John drives Mary to work.
NEXT-WEEK IX-1p HOPE IX-1p PASS TEST	 I hope I pass the test next week.
BOX/ROOM SMALL DCL"small box"	 The box is small.
IX-2p:i FACE NOT FEEL (1h)GOOD/THANK-YOU IX-3p:j #OK IX-2p:i WRONG+ (1h)part:indef	 You look like you don't feel good. Are you okay - what's wrong?
#IF FATHER ARRIVE HOME fs-LATE NIGHT+ (1h)TEND ORDER PIZZA4 DISH	 If father arrives home late at night, he tends to order pizza.
FATHER i:SAME-1p LIKE CHOCOLATE fs-CEREAL part:indef	 Dad is like me. He likes chocolate cereal.
IX-1p 5"exasperation" IX-3p-pl-2:i/j DOUBT-1p NOT NOT-YET DECIDE IX-1p MYSTERY part:indef	 I doubt that the two of them have decided what to do yet, and I'm confused by that.
EMERGENCY IX-loc:i GO-OUT WHERE	 Where do we go if there's an emergency?
POSS-1p+ UNCLE IX-loc:i NEVER VISIT-1p IX-1p NEVER	 My uncle never vists me.
IX-1p BORN BABY IX-1p WANT ns-IRELAND NAME FATHER WANT IX-3p:i ns-FRANCE NAME+	 If I have a baby, I want an Irish name but the father wants a French name.
PRESIDENT GO ns-CHINA #WHEN	 When did the President go to China?
IX-3p-pl-2:i/j fs-JEN fs-JOE MARRY IX-3p-pl-2:i/j QMwg	 Are Jen and Joe married?
BOX/ROOM BIG2 (1h)5"wave no" NOT SMALL (1h)5"wave no"	 The box is really big, it's not small.
MOTHER IX-loc:i SCL:bent-UL"person walking" SELL+	 Mom is walking to the store.
IX-2p WANT+NEG SOMETHING/ONE (1h)part:indef	 You don't want anything?
KID IX-loc:i PLAY-continuative fs-PARK	 Are the kids playing at the park?
(1h)WOW/AWFUL MANY BIG2 DIFFERENT++-arc fs-CAKES IX-1p MUST PICK/CHOOSE ONE 5"perplexed"	 Wow. There are so many big cakes of different kinds; do I have to pick one?
GAME FINISH BEFORE SIX QMwg (1h)part:indef	 Would the game finish before six?
ATTENTION-WAVE POSS-1p+ FRIEND ARRIVE TIME++	 What time did my friend arrive?
IX-2p WANT+NEGATIVE IX-2p	 You don't want anything.
#JOB IX-loc:i part:indef NOT HARD (1h)part:indef	 That job isn't hard.
GO-OUT+ SNOW+ SCHOOL FUTURE CANCEL/CRITICIZE QMwg	 If it's snowing outside a lot, will school be cancelled?
fs-JOHN IX-3p:i BREAK WINDOW #NO+ IX-3p:j fs-JAMES	 John didn't break the window, James did.
REALLY SELF-3p+:i OLD NOT IMPORTANT (1h)part:indef	 Age isn't important.
IX-3p:i (5)MAN BORN WHERE ns-CHICAGO	 Where was the man born? He was born in Chicago.
fs-JOHN IX-3p:i (1h)GOOD/THANK-YOU (2h)alt.LIE IX-1p LCL:bent-B-xd"swallow fish"++ IX-1p REALLY SICK/SILLY IX-3p:i	 John is a really good liar. I fell for everything he said. I'm sick of him.
#IF+ IX-3p:i FATHER ARRIVE HOME fs-LATE NIGHT+ IX-3p:i CANNOT i:HELP-1p WITH POSS-1p-pl HOME+WORK part:indef	 If Father arrives home late at night, he can't help us with our homework.
IX-1p NOT (1h)HAVE ONE-DOLLAR+ (1h)part:indef	 I don't even have one dollar.
FRIEND DEPART CAMP+ #WHEN	 When did the friends go camping?
IX-1p HOPE+ HAVE PINEAPPLE fs-CREAM CHEESE	 I hope there's pineapple cream cheese.
IX-1p READ (2h)ANY+(2h)THING IX-1p (5)NOT fs-CARE part:indef	 I'll read anything, I don't care.
IX-1p (1h)INFORM:i IX-3p:i FINE+ IX-3p:i (1h)part:indef	 No, I told her that it was fine.
BOX/ROOM SMALL NOT	 The box is not small.
IX-1p FRIEND DEPART GUITAR IX-1p THRILL/WHAT'S-UP	 I'm excited for when my friend and I go to the concert.
#IF RAIN++ IX-1p GO-OUT HOME	 If it rains, I`ll go home.
fs-MARY IX-3p:i (1h)HAVE MANY DIFFERENT++-arc FRIEND	 Mary has many different friends.
IX-3p:i CAR NOT BREAK-DOWN MAYBE RUN-OUT #GAS part:indef	 The car didn't break down. Maybe it ran out of gas.
IX-3p:i fs-JOHN NOT HAVE SPECIAL BICYCLE SHOE+ part:indef	 John doesn't have special biking shoes.
SCL:bent-U-L"person walking" SELL+ WHO	 Who walked to the store?
IX-1p READ+ IX-3p:i ARTICLE WRITE2 FOR ns-BOSTON fs-GLOBE IX-3p:i IX-1p THINK GREAT	 I read the article written for the Boston Globe. I think it was great!
fs-MARY SELF-3p+:i NOT VEGETABLE+AGENT	 Mary isn't a vegetarian.
COMPUTER5 POSS:1p SISTER (1h)USE2 fs-MAC ONLY	 My sister only uses Mac computers.
#NO++ IX-1p+ USE2+ CORRECT KEY+	 No, I used the right key.
BACK-OF-MIND AUTOMATIC (1h)part:indef	 I automatically keep information in the back of my mind.
LAST-WEEK IX-1p TEST IX-1p B (1h)part:indef	 I got a B on last week's test.
IX-1p FRESHMAN YEAR POSS-1p FRIEND (2h)LOOK WHY+ IX-1p BALD2 FOLLOW ns-GALLAUDET TRADITION	 My friends during my freshman year were shocked because I was bald. I was following a Gallaudet tradition.
IX-1p WORK SIT-continuative ALL-DAY	 I sat and worked all day.
fs-JOHN IX-3p:i NOT BUY TURKEY #NO+ IX-3p:j fs-JAMES BUY TURKEY	 John didn't buy the turkey, James did.
IX-1p LOVE GET-IN+ AIRPLANE FLY-BY-PLANE              DIFFERENT PLACE	 I love riding in airplanes and flying different places.
#ALL2 LEARN+AGENT PASS TEST NONE SCHOOL TOMORROW	 If all the students pass the test, then there will be no school tomorrow.
GO-OUT GO-OUT GO-OUT HOME	 Go home!
IX-1p FAVORITE/PREFER+ IX-3p:i fs-LOX fs-CREAM CHEESE	 I prefer lox cream cheese.
IX-1p LIKE (2h)ANY+(2h)THING IX-1p (5)NOT fs-CARE part:indef	 No, I like anything, I don't care.
IX-1p ANALYZE MATH+ PROBLEM2 IX-1p LOOK-OVER	 I analyzed and looked over the math problem.
IX-1p NEVER SEE COW PURPLE+	 I've never seen a purple cow.
IX-1p MUST DISCUSS HOW IX-1p CONFRONT TEACH+AGENT REGULAR part:indef	 I have to discuss how I should approach the teacher appropriately.
IX-3p:i WANT+NEG IX-1p DOUBT IX-1p THINK IX-3p:i WANT	 He/she doesn't want anything? I doubt that. I think he/she wants something.
5"hey, no" (2h)MUST WAIT MOTHER+FATHER NOT READY2+ IX-loc:i	 You need to wait. Mom and Dad aren't ready.
PINEAPPLE fs-CREAM+CHEESE+ NONE/NOTHING WHY+ part:indef	 Why isnt't there any pineapple cream cheese?
BOY+ NEVER GO-OUT HOME (1h)part:indef	 The boy never goes home.
IX-3p:i (5)MAN NAB BREAK ENTER HOUSE IX-loc:j fs-NEWTON FEEL ALSO (5)MAN IX-3p:i+ RESPONSIBILITY BREAK IX-loc-pl-arc IN ns-BROOKLINE 5"I don't know"	 I think the man caught breaking and entering a house in Newton is the same man responsible for the break-ins in Brookline.
IX-2p FINISH TAKE-UP INTRODUCE LINGUISTICS CLASS	 Did you take an introduction to linguistics class?
IX-2p:i LIKE ns-BOSTON QMwg	 Do you like Boston?
NOW (5)WEATHER LOUSY	 The weather is lousy today.
IX-1p VERY NOT (1h)HAPPY+	 I am very unhappy.
GO-OUT+ SNOW SCHOOL QMwg CLOSE-DOOR part:indef	 When it snows out a lot school closes right?
IX-3p:i CAR BREAK-DOWN 5"frustration"	 The car broke down.
IX-3p:i MAGAZINE QUOTE/TOPIC PEOPLE fs-PEOPLE KNOW IX-2p THINK (1h)GOOD/THANK-YOU IX-2p QMwg	 Do you think People magazine is any good?
GO-OUT SNOW+ STOP SCHOOL FUTURE fs-RE+OPEN TOMORROW	 If it stops snowing outside then school will reopen tomorrow.
IX-3p:i START ICL"opening can" #NO+ (1h)5"wave no" NOT IX-1p	 It wasn't me who started to open the can.
#IF+ IX-1p NOT STUDY+ IX-1p GUARANTEE FAIL IX-1p	 If I don't study, I am guaranteed to fail.
TIRED (1h)5"wave no"	 I'm not tired.
HOT IX-2p COLD IX-2p	 Are you hot or cold?
IX-1p FINISH ANNOUNCE TOMORROW FUTURE RAIN+	 I already announced that it will rain tomorrow.
FAMILY TAKE-UP DOG DCL:crvd-B"small puppies"	 The family adopted small puppies.
SEE IX-pl-2:i/j fs-JOHN fs-TREAT IX-3p:i fs-MARY WOW/AWFUL IX-1p IX-3p:i RELATIONSHIP-OFF	 John has been treating Mary awfully and I just want her to break up with him.
IX-1p 1p-ASK:i POSS-1p TEACH+AGENT FOR SOME ADVISE/INFLUENCE IX-1p DISCUSS++ part:indef	 I asked my teacher for some advice and we had a discussion.
#WHEN HAVE+ PINEAPPLE fs-CREAM+CHEESE+ IX-3p:i REFUSE EAT fs-BAGEL (1h)part:indef	 When it has pineapple cream cheese on it, he won't eat the bagel.
IX-3p:i fs-MARY KNOW MANY DIFFERENT-arc LANGUAGE	 Mary knows many different languages.
PICK-1p GROUP #CLUB JOIN (2h)5"wow" HONOR	 I was picked to join the club. Wow, it was an honor.
PAST+ TAKE-BREAK IX-1p READY #DO HOMEWORK FROM-NOW-ON EMPTY-FROM-NOW-ON READY	 Last break, I completed all of my homework ahead of time.
IX-1p (1h)TEND WORK-OUT+ OVER/AFTER CLASS	 I tend to exercise after class.
GO-OUT+ SNOW SCHOOL CANCEL/CRITICIZE	 If it's snowing out, then school is cancelled.
COAT RECENT-PAST (1h)PAY/BUY IX-3p:i APPEARANCE WARM IX-3p:i	 The coat you just bought looks warm!
NEXT-WEEK IX-1p GO          AGAIN MOVIE	 I'm going to the movies again next week.
BOX/ROOM SMALL (1h)5"wave no" BIG5	 The box isn't small it's large.
IX-3p:i (5)MAN RECENT-PAST (1h)PAY/BUY SOMETHING/ONE BIG (Y)WOW IX-1p 5"wave no" CANNOT 1p-TELL-2p:j DO-DO+	 Wow, that man recently bought something big, but I can't tell you what it is.
IX-1p+ SWIM-continuative IX-loc:i fs-BEACH	 I swam all day at the beach.
POSS-2p:i SISTER NOT LIKE PINEAPPLE fs-CREAM CHEESE #NO	 No, your sister doesn't like pineapple cream cheese.
EVERY+ONE KNOW+ fs-JOHN DEPART GO-OUT fs-MAINE DRIVE:i	 Everyone knows that John left to drive to Maine.
IX-3p:i POSS-1p NEPHEW IX-loc:i (1h)HAVE STRANGE SHOE RED LIGHT DCL"blinking lights on shoes"	 My nephew has strange shoes that have red blinking lights.
POSS-1p CAR DIFFERENT NOW NOT BIG (1h)NOW SMALL	 My car is different now. It's small not big.
IX-1p BORN ns-BOSTON GROW-UP NOW IX-1p LIVE HERE MANY YEAR	 I was born and raised in Boston. Now, I have lived here for many years.
IX-2p FUTURE SEE IX-2p fs-MARY IX-3p:j (P)PARTY2 NOT-MIND TELL:j j:CALL-1p (1h)part:indef #NO IX-1p DOUBT FUTURE GO-OUT IX-loc:k BUT #IF IX-1p SEE:j IX-2p IX-1p FUTURE TELL:i CALL:k 5"of course"	 You'll see Mary at the party. Would you tell her to call me?I doubt that I'll be going out but if I see her I will tell her to call you.
#IF IX-2p (1h)HAVE BOOK IX-2p IX-1p MAYBE READ IX-1p	 If you have a book, I will probably read it.
5"wave no" NOT EAT COOKIE 5"wave no" IX-loc:i WITH BUTTER+ 5"wave no" 5"ok, hey" IX-1p LIKE BUT #IF IX-3p:i BUTTER+ IX-1p NOT-CARE (1h)part:indef	 ?Don`t eat cookies with butter.? ?Well, I like cookies, but if they have butter, I still don`t care.?
POSS-1p SUGGEST NOT (1h)5"hey no" FLY-BY-PLANE ns-AMERICAN-AIRLINES 5"wave no" EXPENSIVE2 #NO 5"ok, hey" EXPENSIVE2 BUT #IF IX-3p:i EXPENSIVE IX-1p STUCK ANYWAY/NOT-MATTER+ ONLY ONE WITH FLY-BY-PLANE STRAIGHT FROM ns-BOSTON TO/UNTIL fs-MIAMI part:indef	 ?I suggest that you don`t fly with American Airlines because their plane tickets are expensive.? ?No. Well, yes, they are probably expensive but if they are really expensive, I`m stuck because they are the only one with a direct flight from Boston to Miami.?
fs-JOHN IX-3p:i (L)LIVE (1h)LAST-YEAR WHERE	 Where did John live last year?
KNOW fs-DEMI fs-MOORE POSS-3p:i FIRST HUSBAND fs-BRUCE fs-WILLIS	 Demi Moore's first husband was Bruce Willis.
NOW NONE/NOTHING HOMEWORK+	 There's no homework today.
WHEN IX-3p:i PRESIDENT DEPART IX-1p TALK WITH IX-3p:j ANSWER+AGENT	 When the president leaves, I will talk with the reporter.
NOT RAIN NONE/NOTHING2++	 It's not raining.
(1h)WOW/AWFUL NOT RAIN+ NONE/NOTHING part:indef	 Wow, it's not raining at all.
IX-3p:i MUST NOT GO-OUT (S)BASEBALL 5"wave no" FUTURE RAIN+ #NO FUTURE NOT RAIN BUT #IF RAIN STILL REFUSE CANCEL ANYWAY/NOT-MATTER+ part:indef	 "He/she shouldn't go to the baseball game because it's going to rain." "No, it's not going to rain, and even if it did, the baseball game wouldn't be cancelled."
IX-2p WANT GO-OUT BUY SHOE+ IX-2p	 Do you want to go out and buy shoes?
fs-JOHN IX-3p:i NOT TAKE fs-MARY WORK (1h)5"wave no" fs-AMY (1h)TEND	 John won't take Mary to work, he usually takes Amy.
SCL:bent-U-L-"person walking" SELL+ WHO	 Who walked to the store?
WEATHER LOUSY NOW++	 The weather is lousy today.
#IF IX-1p NICE/CLEAN+ KITCHEN MOTHER (1h)i:GIFT-1p TWENTY DOLLAR	 If I clean the kitchen, mom will give me twenty dollars.
fs-JOHN READ BOOK (1h)5"wave no" IX-3p:i fs-JOHN NEVER START BOOK	 Did John read that book? No, he never started it.
NOW+AFTERNOON+ IX-1p FUTURE GO SELL+	 This afternoon I'm going to the store.
SELF-3p+:i MOVIE REALLY SCARE+	 The movie is really scary.
IX-1p DEPART (2h)LOOK MOVIE FINISH (1h)part:indef	 I already went out and saw the movie.
HAPPEN RAIN++ IX-1p IMPOSSIBLE+ FIND/FIND-OUT UMBRELLA (1h)part:indef	 It's raining and it's impossible to find an umbrella.
NOT (1h)PAY/BUY CAR INSURANCE/INFECTION FOR-FOR++	 Why didn't you buy car insurance?
(1h)5"wait" MUST READ BOOK WHY TEST TOMORROW part:indef	 You must read the book because there is a test tomorrow.
POSS-1p+ NEW+ #CAR IX-1p 5"awestruck" KISS-FIST IX-1p	 I love my new car.
#NO IX-1p NOT LIKE PINEAPPLE fs-CREAM CHEESE IX-1p FAVORITE/PREFER+ fs-LOX	 No, I don't like pineapple cream cheese. I prefer lox.
fs-JOHN EAT (1h)"WHAT" fs-CAVIAR	 What does John eat? He eats caviar. Yuck!
POSS-1p (2h)alt.LONG-AGO (2h)LONG-PAST FROM WHERE ns-nat-GERMANY	 My ancestors are from Germany.
(P)PARTY2 NIGHT START EIGHT NINE part:indef	 Does the party tonight start at 8 or 9?
FRIEND GO-OUT TOGETHER/GO-STEADY2	 The friends are out together.
FRIEND IX-loc:i DYE HAIR DCL:5"hair dyed all over" TOGETHER/GO-STEADY2	 Did the friends dye their whole heads together?
NOW (5)WEATHER NOT LOUSY	 The weather's not lousy today.
HOT fs-DAY GO-OUT+ IX-3p:i fs-JOHN GO LIBRARY READ MAGAZINE FINEwg #AC COOL	 If it's hot out, John will go to the library and read a magazine because there is air conditioning in the library.
IX-1p fs-SUSHI IX-1p EAT IX-3p:i TASTE STRANGE IX-1p HOPE NOT RUIN 5"out of my control"	 The sushi I ate tasted weird. I hope it`s not spoiled.
MOTHER IX-loc:i NICE/CLEAN+ KITCHEN	 Did Mother clean the kitchen?
IX-3p:i CAR NOT BREAK-DOWN #NO+	 No, the car didn't break down.
RAIN+ NONE/NOTHING part:indef	 There's no rain.
IX-3p:i ADULT-TALL fs-HEIGHT AFRAID CORRECT QMwg #NO IX-1p NOT (25)WHY IX-3p:i THINK THAT part:indef	 You are afraid of heights, right? No, I'm not afraid of heights. Why would you think that?
LIKE CLASS2	 Do you like class?
#NO IX-1p NOT HAVE CAR	 No, I don't have a car.
IX-1p LOOK fs-JOHN MANIPULATE+ fs-MARY IX-1p (1h)ANGRY HUNGRY/WISH IX-3p-pl-2:i/j RELATIONSHIP-OFF	 I wish John and Mary will stop being in a relationship after seeing John play with her.
fs-JOHN BUY MILK	 Did John buy milk?
BOX/ROOM BIG5 BIG5	 The box is really big.
MOTHER FINISH SCL:bent-U-L"person walking" SELL++	 Did mom already walk to the store?
LIE (1h)FINISH NOT FUNNY WHERE MOTHER+ (1h)part:indef	 Stop lying, it's not funny. Where's Mom?
IX-2p LIKE CHOCOLATE IX-2p KISS-FIST IX-3p:i SHEET-CAKE FUTURE IX-2p	 If you like chocolate, you will love this cake.
DEPART WHO	 Who is going out?
IX-1p (2h)LOOK MOVIE PAST+NIGHT ACT+AGENT (1h)GOOD/THANK-YOU	 I watched a movie last night and the actor was good.
FRIEND DYE HAIR DCL:5"hair dyed all over" TOGETHER/GO-STEADY2	 The friends dye their hair many colors together.
IX-1p TIRED TIRED (1h)WOW/AWFUL	 Wow, I'm really tired.
WHEN FRIEND IX-3p:i PROCEED START DYE DCL:5"hair dyed all over" OTHER IX-3p-pl-arc FRIEND FINE++ JOIN++	 When my friend starts dying their hair, other friends will think it's cool and start joining.
#IF++ HAVE PINEAPPLE fs-CREAM+fs-CHEESE IX-1p+++ REFUSE EAT+ DCL:crvd-L"bagel" fs-BAGEL IX-1p (1h)part:indef	 If it has pineapple cream cheese on it, I won't eat the bagel.
WORK HARD BOSS LIKE IX-2p	 If you work hard, the boss will like you.
IX-1p SEE FRIEND TOMORROW IX-1p THRILL/WHAT'S-UP	 I will be thrilled if I see my friend tomorrow.
IX-3p:i LCL:3"parked car" RED LIGHT HIT2 IX-1p FEEL IX-loc:j CAR+AGENT PHONE (1h)L-X"I don't know" THINK (1h)L"I don't know"	 The guy who hit the parked car at the red light was talking on the phone, I think
IX-3p:i MOTHER AND BOY             IX-pl-2:i/j SCL:V/2"two of them go together" LIBRARY	 The mother and the boy are both going to the library.
IX-3p:i CAR REALLY+WORK BREAK-DOWN YES+	 Yes, the car really is broken down.
SEE PRESIDENT LONG-AGO #TV IX-1p LOOK NOW (L)LIVE IX-1p LOOK FACE DIFFERENT	 I used to see the president on TV, but in person, he looks different.
fs-JACK (1h)HAVE (1h)(flat-O)PAY/SPEND+ QMwg (1h)part:indef	 Does Jack have money?
IX-1p LONG-AGO+ (1h)TEND READ2 ns-NEW-YORK2 TIME+ NOW IX-1p (1h)5"forget it" IX-1p READ+ ns-BOSTON fs-GLOBE DIFFERENT (1h)WOW/AWFUL	 I used to read the New York Times, but now I read the Boston Globe and wow it's different.
GO-OUT+ COLD IX-1p KISS-FIST HOT CHOCOLATE DRINK	 When it's cold outside, I love drinking hot chocolate.
IX-3p:i fs-MARY STOP ROWING (1h)5"wave no" IX-3p:i NEVER ROWING UP-TO-NOW NOW	 Did Mary stop rowing? No, she's never rowed until now.
part:indef IX-1p+ LIKE CHOCOLATE DRY-CEREAL IX-1p (1h)part:indef	 Hey! I like chocolate cereal.
IX-3p:i NOT FINISH (25)WHY IX-3p:i REST+++	 He/She didn't finish because he/she was laying around.
IX-1p NICE/CLEAN++ FINISH KITCHEN FINISH MOTHER FUTURE TAKE-OUT IX-1p FRIEND HOUSE	 When I finish cleaning the kitchen, my mom will take me to a friend's house.
IX-3p:j fs-JIM ASSAULT (5)MAN IX-3p:i (1h)NOW IX-3p:i THREAT FUTURE i:SUE:j fs-JIM 5-C-L"out of my control"	 Jim assaulted a man and now the man is threatening to sue Jim.
BUY FLOWER WHO (1h)part:indef	 Who bought the flowers?
FATHER+ IX-3p:i LIKE CHOCOLATE fs-CEREAL IX-3p:i (1h)5"you know"	 Dad likes chocolate cereal.
IX-2p GO SCHOOL TOMORROW	 Are you going to school tomorrow?
#IF TOMORROW CLOSE-DOOR SCHOOL++ CLOSE-DOOR KID GUARANTEE PLAY-contiuative SNOW	 If school is closed tomorrow, kids will play in the snow.
fs-JOHN IX-loc:i GO-OUT LIBRARY READ2+ (1h)GOOD/THANK-YOU BOOK	 John is going to the library to read a good book.
(1h)WOW/AWFUL IX-3p:i (5)MAN IX-loc:i KNOW+ fs-GEORGE-CLOONEY	 Wow, that man knows George Clooney.
(1h)LAST-YEAR IX-1p-pl-2:i READ+ MANY BOOK+	 Last year, we read a lot of books.
#IF TOMORROW SNOW GUARANTEE SCHOOL FUTURE CLOSE-DOOR	 If it snows tomorrow, then it's a guarantee that school will be closed.
DCL:crvd-B"small puppies" DOG SMALL IX-loc:i FAMILY IX-loc:j TAKE-UP	 Did the family adopt the small puppies?
WHO IX-3p:i LIKE IX-3p:i	 Who does he/she like?
CAR IX-3p:i (1h)(flat-O)PAY/SPEND YESTERDAY DO-DO+ KIND part:indef	 What kind of car did you buy yesterday?
THAT AGENT IX-3p:i WHO STEAL PAINT2+ IX-loc:i IX-3p-pl-arc REFUSE NAB IX-3p:i	 They won't catch the thief that stole the paintings.
CAR BREAK-DOWN (1h)5"wave no"	 The car didn't break down.
IX-loc:i WRITE ONE WRONG WORD SMALL-AMOUNT IX-3p:i (2h)DELETE3 FUTURE	 Even if there's only one tiny mistake, it will be tossed out.
IX-3p:i WANT+NEG NONE/NOTHING2 (1h)part:indef	 He/She doesn't want anything?
EVERYDAY MANY CHILDREN BORN++++	 Many children are born everyday.
IX-1p ALWAYS SERIOUS IN SCHOOL	 I'm always serious in school.
IX-1p NOT WANT READ+ IX-1p WANT DEPART	 I don't want to read; I want to leave.
(Y)YESTERDAY #BUS IX-1p SIT-continuative (5)MAN STRANGE LCL:curved-V "person sit next to me" TALK++ IX-1p            part:indef	 Yesterday I was on the bus and a strange man sat next to me and started talking. I just stared at him.
(1h)5"wave no" SERIOUS CAR BREAK-DOWN IX-1p KEY++ CORRECT part:indef	 I'm serious, the car is broken. I tried the key but it isn't working.
MOTHER NICE/CLEAN+ KITCHEN	 Mother cleans the kitchen.
RAIN+ MAYBE TRAIN fs-LATE	 The train may be late if it's raining.
FATHER i:SAME-1p LIKE PINEAPPLE fs-CREAM CHEESE	 My father and I are alike. We both like pineapple cream cheese.
POSS-1p+ OTHER FRIEND IX-3p-pl-arc JOIN IX-1p PAST+NIGHT	 My other friends joined me last night.
LONG-AGO+ IX-1p LIE+ NOW IX-1p (1h)FINISH IX-1p TELL HONEST	 I used to lie but now I tell the truth.
IX-1p FRIEND KISS-FIST DEPART++ (25)WHY KISS-FIST CAMP+++	 My friend loves going out because he loves camping.
CHILDREN SWIM WHERE	 Where are the children swimming?
bent-B-L"wow" IX-3p:i DEPART FAST	 Wow, he/she left fast.
CAR BREAK-DOWN	 The car didn`t break down.
IX-3p:i fs-PETE LOVE DRIVE+ (1h)HAVE DIFFERENT++-arc CAR+	 Pete loves driving; he has many different cars.
IX-1p LIKE IX-3p:i BOY IX-3p:i FUNNY IX-3p:i	 I like that boy. He's funny.
IX-1p LIKE PINEAPPLE fs-CREAM CHEESE YES	 Yes, I like pineapple cream cheese.
TEACH+AGENT NOT i:INFORM-1p CLASS CANCEL/CRITICIZE IX-1p ENTER CLASS IX-1p SIT-continuative TWENTY MINUTE WAIT+ 5"exasperation"	 The teacher didn't tell me class was cancelled so I went and sat there waiting for about twenty minutes.
POSS-1p BROTHER FIND/FIND-OUT BRACELET SELF-3p:i REALLY fs-GOLD	 My brother found a bracelet that is real gold!
POSS-1p PAY IX-1p INCREASE LITTLE-BIT SMALL-AMOUNT INCREASE part:indef	 My pay increased a little bit.
FRIEND DEPART CAMP+ WHERE	 Where did the friends go camping?
IX-1p KNOW+ IX-3p:i DEPART TOMORROW+	 I know he/she leaves tomorrow.
IF IX-2p STUDY IX-2p FUTURE A CLASS	 If you study consistently, you will ace the class.
IX-3p:i WIN fs-LOTTERY DEPART ns-nat-JAMAICA (1h)part:indef	 If you win the lottery, will you go to Jamaica?
POSS-1p CAT IX-loc:i ONLY EAT CAT EAT++ (1h)part:indef FINISH	 My cat only eats cat food.
LIKE WORK IX-2p	 Do you like work?
(1h)NOW RECENT-PAST ARRIVE NOW	 I just arrived now.
IX-1p CANNOT BELIEVE RAIN NONE/NOTHING2 IX-1p SURPRISE part:indef	 I can't believe it's not raining. I'm surprised.
#IF IX-3p:i FAMILY IX-loc:i NOT TAKE-UP IX-3p-pl-arc DCL:crvd-B"small puppies" DOG part:indef POSS-1p FRIEND FUTURE	 If the family doesn't adopt the puppies, my friend will.
NOW (1h)GOOD/THANK-YOU fs-DAY QMwg	 Is today a good day?
POSS-1p FATHER LONG-AGO+ ADULT-TALL NOW SHORT-HEIGHT+	 My father used to be tall but now he's short.
NEXT-WEEK IX-1p DEPART SPEND MONEY AGAIN	 I'm going out again next week to spend all my money.
HAPPEN IX-1p STUDY (1h)5"exasperation" HAVE fs-POP #QUIZ	 When I don't study, there is always a pop quiz.
TAKE-UP DCL:crvd-B"small puppies" DOG WHO	 Who adopted the small puppies?
KID IX-loc:i PLAY-continuative fs-PARK	 Is the kid playing in the park?
IX-2p WANT BUTTER IX-2p	 Do you want butter?
MOTHER MUST NICE/CLEAN+ KITCHEN SOON (25)WHY fs-GUEST GO EAT+NIGHT+	 Mom has to clean the kitchen because soon she is having guest over for dinner.
fs-JOHN          DRIVE fs-MARY WORK	 John drives Mary to work.
IX-1p HAVE APPOINTMENT (1h)NOW+AFTERNOON2 WITH POSS-1p TEACH+AGENT	 I have an appointment this afternoon with my teacher.
fs-JOHN #NO+ (1h)TEND TAKE fs-MARY NOT IX-3p:i (1h)TEND SCL:1"John and Mary walk together" (3)WALK+ SCL:1"John and Mary walk together" TO/UNTIL WORK+	 John doesn't usually take Mary to work, they usually walk to work together.
fs-MARY IX-3p:i THAT (5)MAN IX-3p:i DEPART TOMORROW	 Mary and that man leave tomorrow.
RAIN NONE/NOTHING2 NOW GO-OUT+ NONE/NOTHING2 5"perplexed"	 It's not raining outside right now.
